10 12 300
S..#..*...#.
.##..#..*...
..*..#...#..
..##..*..#..
...!*....#..
..*..#..*..#
.#..##..*...
..*....#..#.
...#..*..#..
..#...*..#..
0
1
