7 9 160
S..#..*..
.##..#..*
..*..#...
..##..*..
...!*....
..*..#..*
..#...*..
0
1
